11111111111111111111
11000000000000000011
10000000000000000001
11000000000000000001
10000000000000000011
11000000000000000001
10000000000000000011
11000000000000000001
10000000000000000011
11000000000000000001
10000000000000000011
11000000000000000001
10000000000000000011
11000000000000000001
10000000000000000011
11000000000000000001
10000000000000000011
10000000000000000001
11000000000000000011
11111111111111111111